Monster1 02 05 100 100 12 41
Monster2 11 00 100 100 17 42
Monster3 10 12 100 100 13 43
Monster4 12 13 100 100 11 44
[MAPCODE]
Monster7 11 10 100 100 11 47
[GOODMONSTER]
01 01 01 02 02 02 02 02 01 01 01 01 01 01 01 01
01 01 01 02 04 04 04 02 01 01 01 01 03 03 08 01
03 03 01 02 04 04 04 02 01 01 01 01 03 03 08 08
03 03 01 02 04 04 04 02 01 01 03 03 03 03 03 03
03 03 01 02 04 04 04 02 01 01 03 03 03 03 03 03
03 03 01 02 04 04 04 02 01 01 03 03 03 03 03 03
03 03 01 02 02 02 02 02 01 01 03 03 03 03 03 03
03 03 01 01 01 01 01 01 01 01 03 03 03 03 03 03
03 03 01 03 03 03 03 03 03 03 03 03 03 03 03 03
03 03 01 03 03 03 03 03 05 05 05 05 05 05 05 05
03 03 01 03 03 03 03 03 05 05 05 05 05 05 05 05
03 03 01 03 03 01 01 01 05 05 01 01 01 01 01 05
03 03 01 07 01 01 01 06 06 06 06 01 01 01 01 05
03 03 03 03 03 01 01 01 05 05 01 01 01 01 01 05
03 03 03 03 03 03 03 03 05 05 05 05 06 05 05 05
03 03 03 03 03 03 03 03 05 05 05 05 52 05 05 05
[ITEM]
Item1 13 00 60 60 61
Item2 12 14 40 100 62
