Monster4 03 03 100 100 11 44
Monster5 05 07 100 100 12 45
Monster6 06 07 100 100 13 46
Monster7 06 09 100 100 12 41
[MAPCODE]
[GOODMONSTER]
03 03 03 03 03 03 03 05 05 05 05 05 51 05 05 05
03 03 03 03 03 03 03 03 03 03 03 01 06 01 03 03
03 03 03 03 03 03 03 03 03 03 03 01 01 01 03 03
01 01 01 01 01 01 01 01 01 01 01 01 01 01 03 03
01 01 02 02 02 02 02 02 02 02 02 02 02 02 03 03
01 01 02 02 01 01 01 01 01 01 01 01 01 02 03 03
01 01 02 01 01 01 01 01 01 01 01 01 01 02 03 03
01 01 01 01 01 01 01 01 01 01 01 01 01 02 03 03
01 01 02 01 01 01 01 01 01 01 01 01 01 02 03 03
01 01 02 02 01 01 01 01 01 01 01 01 01 02 03 03
01 01 02 02 02 02 02 02 02 02 02 02 02 02 03 03
01 01 01 01 01 01 01 01 01 01 01 01 01 01 03 03
03 03 03 03 03 03 03 01 01 01 01 01 01 01 03 09
03 03 03 03 03 03 03 03 01 01 01 01 01 01 07 53
03 03 03 03 03 03 03 03 03 01 01 01 01 01 03 09
03 03 03 03 03 03 03 03 03 03 01 01 01 01 03 03
[ITEM]
Item2 09 07 50 100 62
Item3 05 11 80 50 61