Monster8 05 13 100 100 10 44
Monster9 12 13 100 100 12 45
Monster10 12 06 100 100 13 46
Drake 13 01 300 300 40 48
[MAPCODE]
[GOODMONSTER]
10 10 09 09 09 09 09 09 09 09 09 09 09 09 09 10
10 10 09 01 01 01 01 01 07 01 01 01 01 01 09 10
10 10 09 01 01 01 01 01 09 01 01 01 01 49 09 10
10 10 09 09 07 09 09 09 10 10 10 10 10 10 10 10
10 10 08 08 01 01 01 01 10 10 10 01 01 01 10 10
10 10 08 01 01 01 01 01 10 10 01 01 01 01 01 10
10 10 08 01 01 01 01 06 06 06 06 01 01 01 01 10
10 10 08 01 01 01 01 01 10 10 01 01 01 01 01 10
10 10 08 08 01 01 01 01 10 10 10 01 06 01 10 10
10 10 10 10 10 10 10 10 10 10 10 10 06 10 10 10
10 10 10 10 10 10 10 10 10 10 10 10 06 10 10 10
10 10 10 10 01 01 01 10 10 10 10 01 06 01 10 10
09 09 10 01 01 01 01 01 10 10 01 01 01 01 01 10
52 06 06 06 01 01 01 06 06 06 06 01 01 01 01 10
09 09 10 01 01 01 01 01 10 10 01 01 01 01 01 10
10 10 10 10 01 01 01 10 10 10 10 01 01 01 10 10
[ITEM]